[Layout]
9 9 9 9 9 9 9 9 9 9 9 9 9 9 9 9 
9 6 0 0 0 0 0 0 0 0 0 0 0 0 5 9 
9 2 4 4 4 4 4 4 4 4 4 4 4 4 1 9 
9 2 4 4 4 4 4 4 4 4 4 4 4 4 1 9 
9 2 4 4 4 4 4 4 4 4 4 4 4 4 1 9 
9 2 4 4 4 4 4 4 4 4 4 4 4 4 1 9 
9 2 4 4 4 4 4 4 4 4 4 4 4 4 1 9 
9 2 4 4 4 4 4 4 4 4 4 4 4 4 1 9 
9 2 4 4 4 4 4 4 4 4 4 4 4 4 1 9 
9 2 4 4 4 4 4 4 4 4 4 4 4 4 1 9 
9 8 3 3 3 3 3 3 3 3 3 3 3 3 7 9 
9 9 9 9 9 9 9 9 9 9 9 9 9 9 9 9 
